27 27 28 0 0 0 0 26 27 27 27 27 27 27 27 27 27 27 27 27 27 27 27 27 
43 43 44 0 0 0 0 26 27 27 27 27 27 27 27 27 27 27 27 27 27 27 27 27 
11 11 11 11 11 11 12 26 27 27 27 27 27 27 27 27 27 27 27 27 27 27 27 27 
27 27 27 27 27 27 28 26 27 27 27 27 27 27 27 27 27 27 27 27 27 27 27 27 
27 27 27 27 27 27 28 26 27 27 27 27 27 27 27 27 27 27 27 27 27 27 27 27 
27 27 27 27 27 27 28 42 43 43 43 43 43 43 43 43 43 43 59 27 27 27 27 27  
27 27 27 27 27 27 28 10 11 11 11 11 11 11 11 11 11 12 26 27 27 27 27 27 
27 27 27 27 27 27 28 26 27 27 27 27 27 27 27 27 27 28 26 27 27 27 27 27 
27 27 27 27 27 27 28 26 27 27 27 27 27 27 27 27 27 28 26 27 27 27 27 27 
27 27 27 27 27 27 28 26 27 27 27 27 27 27 27 27 27 28 42 43 43 43 43 43 
43 43 43 43 43 43 44 26 27 27 27 27 27 27 27 27 27 74 12 0 0 0 0 
0 0 0 0 0 0 0 26 27 27 27 27 27 27 27 27 27 27 74 12 0 0 0 0 
0 0 0 0 0 0 0 26 27 27 27 27 27 27 27 27 27 27 27 74 12 0 0 0 
0 0 0 0 0 0 0 26 27 27 27 27 27 27 27 27 27 27 27 27 74 12 0 0 
